3333333333333333333333333333333333333333333333333333333333333333333333333333333
3000000000000000000000000000000000000000000000000000000000000000000000000000003
3000000000000000000000000000000000000000000000000000000000000000000000000000003
3000000000000000000000000000000000000000000000000000000000000000000000000000003
3000000000000000000000000000000000000000000000000000000000000000000000000000003
3000000000000000000000100000000000000000000000000000000000000000000000000000003
3000111111110000000100000000000000000000000000010000000000000000000000000000003
3002222222222001000000000000000001000010000100000000000000000000000000000000003
3000022222222000000000000000100000000000000000000000000000000000000000000000003
3000002202000000000000000000000000000000000000000000001000000000000000000000003
3000002000000000000000000000000000000000000000000000000001001100000000000000003
3000000000000000000000000000000000000000000000000000000000002000000000000000003
3000000000000000000000000000000000000000000000000000000000000000000010000000003
3000000000000000000000000000000000000000000000000000000000000000000000000100003
3000000000000000000000000000000000000000000000000000000000000000000000000000003
3000000000000000000000000000000000000000000000000000000000000000000000000000003
3000000000000000000000000000000000000000000000000000000000000000000000000000013
3000000000000000000000000000000000000000000000000000000000000000000000000100003
3000000000000000000000000000000000000000000000000000000000000000000000000000003
3000000000000000000000000000000000000000000000000000000000000000000000000000003
3000000000000000000000000000000000000000000000000000000000000000000001000000003
3000000000000000000000000000000000000000000000000000000001000000010000000000003
3000000000000000000000000000000000000000000000000000010000000001000000000000003
3000000000000000000000000000000000000000000000000000000000000000000000000000003
3000000000000000000000000000001000001100100001000001000000000000000000000000003
3000000000000000000000000010000000000000000000000000000000000000000000000000003
3000000000000000000000000000000000000000000000000000000000000000000000000000003
3000000000000000000000100000000000000000000000000000000000000000000000000000003
3000000000000000000000000000000000000000000000000000000000000000000000000000003
3000000000000001000000000000000000000000000000000000000000000000000000000000003
3000000000000000000000000000000000000000000000000000000000000000000000000000003
3000000000000000000000000000010110000011100000100000000000000000000000000000003
3000000000000000001000010010000000000000000000000001000001000000000000000000000
3000000000000000000000000000000000000000000000000000000000000000000000000000000
3000000000000000000000000000000000000000000000000000000000000001100010011001111