3333333333333333333333333333333333333333333333333333333333333333333333333333333
3000000000000000000000000000000000000000000000000000000000000000000000000000003
3000000000000000000000000000000000000000000000000000000000000000000000000000003
3000000000000000000000000000000000000000000000000000000000000000000000000000003
3000000000000000000000000000000000000000000000000000000000000000000000000000003
3000000000000000000000000000000000000000000000000000000000000000000000000000003
3000000000000000000000000000000000000000000000000000000000000000000000000000003
3111111111111111111101100010010000100000111000001000010000011110000000000000003
3022222222222222222200200020000000200000020000000000000000122221000000000000003
3000222222222222222200000000000000000000000000000000000000000200000010000000003
3000000222222222200000000000000000000000000000000000000000000000000000000000003
3000000222222220000000000000000000000000000000000000000000000000000000001000003
3000000002222000000000000000000000000000000000000000000000000000000000000000003
3000000000000000000000000000000000000000000000000000000000000000000010000000003
3000000000000000000000000000000000000000000000000000000000000001000000000000003
3000000000000000000000000000100000010000000100001000001100000020000000000000003
3000000000000000000000000000000000000000000000000000000200000000000000000000003
3000000000000000000000010000000000000000000000000000000000000000000000000000003
3000011111000010000100000000000000000000000000000000000000000000000000000000003
3000222222000000000000000000000000000000000000000000000000000000000000000000003
3000000000000000000000000000000000000000000000000000000000000000000000000000003
3100000000000000000000000000000000000000000000000000000000000000000000000000003
3000000000000000000000000000000000000000000000000000000000000000000000000000003
3000010000010000001000111000000000000000000000000000000000000000000000000000003
3000000000000000000000002000000000000000010000000001000000000000000000000000003
3000000000000000000000000000001000010000000000000000000000000000000000000000003
3000000000000000000000000000000000000000000000000000000000100000000000000000003
3000000000000000000000000000000000000000000000000000000000000000100001000000003
3000000000000000000000000000000000000000000000000000000000000000000000000000003
3000000000000000000000000000000000000000000000000000000000000000000000000000003
3000000000000000000000000000000000000000000000000000000000000000000000000000003
3000000000000000000000000000000000000000000000000000000000000000000000001000003
3000000000000000000000000000000000000000000000000000000000000000000000000000003
3000000000000000000000000000000000000000000000000000000000000000000000000000003
3000000000000000000000010000000100000100000000000000000000010000001000000100003
3000000000000000010000000000000000000000100000100000001000000000000000000000003
3000000000000000000000000000000000000000000000000000000000000000000000000000003
3000000000000100000000000000000000000000000000000000000000000000000000000000000
3000000000000000000000000000000000000000000000000000000000000000000000000000000
3000000000000000000100000010001000000100000010000000100000100000100000011111111