3333333333333333333333333333333333333333333333333333333333333333333333333333333
3000000000000000000000000000000000000000000000000000000000000000000000000000003
3000000000000000000000000000000000000000000000000000000000000000000000000000003
3000000000000000000000000000000000000000000000000000000000000000000000000000003
3000000000000000000000000000000000000000000000000000000000000000000000000000003
3000111111101100010011001001100010000110001100110000100001000011000110000000003
3001222222202000020002000002200020000200002200000000000002000020000220011000003
3002222222200000000000000000000000000000000000000000000000000000000000002000003
3000222222200000000000000000000000000000000000000000000000000000000000000000003
3777777777777777777777777777777777777777777777777777777777777777777777777770003
3333333333333333333333333333333333333333333333333333333333333333333333333333003
3000000000000000000000000000000000000000000000000000000000000000000000000000013
3000000000000000000000000000000000000000000000000000000000000000000000000000003
3000000000000000000000000000000000000000000000000000000000000000000000000000003
3000000000000000000000000000000000000000000000000000000000000000000000000001003
3000000000000000000000000000000000000000000000000000000000000000000000000000003
3000000000000000000000000000000000000000000000000001000100000100001000010000003
3000011001000000000000000000000000000000000000000000000000000200000000000000003
3000020002000000000000000000000000000001001001110000000000000000000000000000003
3001000000001000000000000000110000000002000000000000000000000000000000000000003
3000000000000110010000000000220011100000000000000000000000000000000000000000003
3000000000000000021100001100000002200000000000000000000000000000000000000000003
3000000777777777777777777777777777777777777777777777777777777777777777777777773
3010000333333333333333333333333333333333333333333333333333333333333333333333333
3000000000000000000000000000000000000000000000000000000000000000000000000000003
3000000000000000000000000000000000000000000000000000000000000000000000000000003
3000000000000000000000000000000000000000000000000000000000000000000000000000003
3000000000000000000000000000000000000000000000000000000000000000000000000000003
3001000000000000000000000000000000000000000000000000000000000000000000000000003
3002110000000000000000000000000000000000000000000000000000000000000000000000003
3000000110000000000000000000000000000000000000000000000000000000000000000000003
3000000021000000000000000000000000000000000000000000000000000000000000000000003
30000000000000000000000000000000000000000000000000000000000000000000000000000033
30000000000011110001110001100100011000000000000000000000000000000000000000000003
30000000000022200000220000000000022000100000000000000000000000000000000000000003
30000000000000000000000000000000000000211000000000000000000000000000000000000003
30000000000000000000000000000000000000000000010000000000000000000000000000000803
30000000000000000000000000000000000000000000000000011000011100000000011000013333
3000000000000000000000000000000000000000000000000000200000021000111000000012003
3000000000000000000000000000000000000000000000000000000000000000000000000000003
3000000000000000000000000000000000000000000000000000000000000000000000000000003
3000000000000000000000000000000000000000000000000000000000000000000000000000003
3000000000000000000000000000000000000000000000000000000000000000000000000000003
3000000000000000000000000000000000000000000000000000000000000000000000000000003

