333333333333333333333333333333333333333333333333333333333333333333333333333333333333333333333333333333333333333333333333333333333333333333333333333333
300000000000000000000000000000000000000000000000000000000000000000000000010000000000000000000000000000000000000000000000000000000000000300000000000003
300000000000000000000000000000000000000000000000000000000000000000000000020000000000000000000000000000000000000000000000000000000000000300000000000003
300000000000000000000000000000000000000000000000000000000000000000000000020000000000000000000000000000000000000033333333333333333333000300000000000003
300000000000000000000000000000000000000000000000000000000000000000000000020001000100001000000000000000000000001330000000000000000003000300000000000003
300000000000000000000110010001000100000000000000000000000000000000000000021002000200000000000000000000000001000300000000000000300003000300000000000003
300000000000000000001200000000000000100000000000000000000000000000000000020002000000000000000000000000000000000300000000000003333333000300000000000003
300000000000000000012000000000000000000000000000000000001000001100000000000012000000000000000000000000000000013300000000000000000000000300000000000003
300000000000000000120000000000000000000000001000000000010000000010000000000002000000000000000000000000000000003300000000000000000000000300000000000003
311111111111111111200000000000000000000010000001111111100000000001111110011002000000000000000000111111000001003003333333333333333333000300000000000003
322222222222222222000000000000000000000000000012222222200000000002222220000000000000000001111111222200000002003003000000000000000000000300000000000003
322222222222222222111111111111111111111111111122222222211111111112222221111111111111111112222222222211111112113033000000000000000000000300000000000003
300000000000000000000000000000000000000000000000000000000000000000000000000000000000000000000000000000000000003003003333333333333333333300000000000003
300000000000000000000000000000000000000000000000000000000000000000000000000000000000000000000000000000000000003303000000000000000000000300000000000003
300000000000000000000000000000000000000000000000000000000000000000000000000000000000000000000000000000000000003003000000000000000000000111111111100003
300000000000000000000000000000000000000000000000000000000000000000000000000000000000000000000000000000000000003003000000000000000000000000000000200003
300000000000000000000000000000000000000000000000000000000000000000000000000000000000000000000000000000000000003033333333333333333333333111111110200003
300000000000000000000000000000000000000000000000000000000000000000000000000000000000000000000000011000000000003000000000000000000000003000000020200003
300000000000000000000000000000000000000000000000000000000000000000000000000000000000000001111111122111111100003000000000000000000000003000000020200003
300000000000000000000000000000000000000000000001111111111001101100000111111111111000000012200000000000000010003333333333333333333333333000000020200003
300000000000000000000000000000000000000000000012000000000000002200000222222222220000000022200000000000000001000000000000000000001111111111111120200003
300000000000000000000000000000000000000000000122000000000000002000000000000022221100000022200000000000000000100000000000000000000000000000000000200003
300000100111101000110001110000000000000000001200000000000000002000000000000022222200000022200000000000000000211111111111111111111111111111111111200003
300000000000000000000000021111111111111111112000000000000000002000000000000022222200000022200000000000000000000000000000000000000000000000000000000003
300010000000000000000000000000000000000000000000000000000000002000000000000022222000000022200000000000000000000000000000000000000000000000000000000003
310000000000000000000000000000000000000000000000000000000000000100000000000022222000000022200000000000000000000000000000000000000000000000000000000003
300000000000000000000000000000000000000000000000000000000000000200000000000022222000000022200000000000000000000000000000000000000000000000000000000003
300000000000000000000000000000000000000000000000000000000000001200000000000022222000000022200000000000000000000000000000000000000000000000000000000003
301000000000000000000000000000000000000000000000000000000000000000000000000002220000000000000000000000000000000000000000000000000000000000000000000003
300000000000000000000000000000000000000000000000000000000000000000000000000002220000000000000000000000000000000000000000000000000000000000000000000000
300100000000000000000000000000000000000000000000000000000000000000000000000002200000000000000000000000000000000000000000000000000000000000000000000000
300000000000000000000000000000000000000000000000000000000000000000000000000000200000000000000000000000000000000000000000000000000000000000000000000000
300001000000000000000000000000000000000000000000000000000000000000000000000000000000000000000000000000000000000000000000000000000000011011110011111113
300000000000000000000000000000000000000000001000000000000000000000000000000000000000000000000000000000000000000000000000000000000001002000000000000003
300000011111111110000100001000100100000001000001000000100000010010001010020001111100000111110010000100001000100010001000010000001002002000000000000003
300000022222222220000000000000000000001000000000001000200000000000000000000000000000000000000000000000000000000000000000000000000000000000000000000003
300000000000000000000000000000000000000000000000000000000000000000000000000000000000000000000000000000000000000000000000000000000000000000000000000003

