333333333333333333333333333333333333333333333333333333333333333333333333333333333333333333333333333333333333333333333333333333333333333333333333333333333333333333333333333333333333333333333333333333333333333333333333333333333333333333333333333333333333333333333333333333333333333333333333333333333333
300000000000000000000000000000000000000000000000000000000000000000000000000000000000000000000000000000000000000000000000000000000000000000000000000000000000000000000000000000000000000000000000000000000000000000000000000000000000000000000000000000000000000000000000000000000000000000000000000000000003
300000000000000000000000000000000000000000000000000000000000000000000000000000000000000000000000000000000000000000000000000000000000000000000000000000000000000000000000000000000000000000000000000000000000000000000000000000000000000000000000000000000000000000000000000000000000000000000000000000000003
300000000000000000000000000000000000000000000000000000000000000000000000000000000000000000000000000000000000000000000000000000000000000000000000000000000000000000000000000000000000000000000000000000000000000000000000000000000000000000000000000000000000000000000000000000000000000000000000000000000003
311111110011001000000000000000000000000000000000000000000000000000000000000000000000000000000000000000000000000000000000000000000000000000000000000000000000000000000000000000000000000000000000000000000000000000000000000000000000000000000000000000000000000000000000000000000000000000000000000000000003
322222220020002000010000100001111000101110000011110001010100001000100000000000000000000000000000000000000000000000000000000000000000000000000000000000000000000000000000000000000000000000000000000000000000000000000000000000000000000000000000000000000000000000000000000000000000000000000000000000000003
322222200000000000000000000000220000000000000000000000000000002000000000000000000000000000000000000000000000000000000000000000000000000000000000000000000000000000000000000000000000000000000000000000000000000000000000001111000000000000000000000000000000000000000000000000000000000000000000000000000003
322220000000000000000000000000000000000000000000000000000001000000000000000000000000000000000000000000000000000000000000000000000000000000000000000000000000000000010000000000000000000000000000000000000000000000000000002222100000000000000000000000000000000000000000000000000000000000000000000000000333
322200000000000000000000000000000000000000000000000000000000000000000100000000000000000000000000000000000000000000000000000000000000000000000000000000000000000001121001100001000010001100000100000100000100001110000010000222200100000000000001110001000100000000000000000000000000000000000000000000000000
322000000000000000000000000000000000000000000000000000000000000000000210000000000000000000000000000000000000000000000000000000000000000000000000000000000000000002222002200000000020002200000000000210000000000220000000000222200000100000001002000002000000100000000000000000000000000000000000000000000000
320000000000000000000000000000000000000000000000000000000000000000000221000000000000000000000000111111001100011000001100010000100000100001100001000001000000111002222000000000000000000000000000000000000000000000000000000000000000000000000000000000000000211100000000111000100000000111100100111000001333
300000000000000000000000000000000000000000000000000000000000000000000222100000000000000000000001222222002200002000000000000000000000000000000000000000000010000000220000000000000000000000000000000000000000000000000000000000000000000010000000000000000000222211111110000010001111100000000000000000000003
300000000000000000000000000000000000000000000000000000000000000000000222211000011100010000100100222200000000000000000000000000000000000000000000000000000000000000020000000000000000000000000000000000000000000000000000000000000000000000000000000000000000222222222200000000002222200000000000000000000003
300000000000000000000000000000000000000000000000000000000000000000000222222000022200000000000000022000000000000000000000000000000000000000000000000000000000000000000000000000000000000000000000000000000000000000000000000000000000000000000000000000000000222222222200000000002222200000000000000000000003
333333333333333333333333333333333333333333333333333333333333333333333333333333333333333333333333333333333333333333333333333333333333333333333333333333333333333333333333333333333333333333333333333333333333333333333333333333333333333333333333333333333333333333333333333333333333333333333333333333333333