333333333333333333333333333333333333333333333333333333333333333333333333333333333333333333333333333333
300030000000000000000000000000000000000000000000000000000000000000000000000000000000000000000000000003
300030000000000000000000000000000000000000000000000000000000000000000000000000000000000000000000000003
300030000000000000000000000000000000000000000000000000000000000000000000000000000000000000000000000003
300000000000000000000000000000000000000000000000000000000000000000000000000000000000000000000000000003
300000000000000000000000000000000000000000000000000000000000000000000000000000000000300033000333300003
300000000000000000000000000000000000000000000000000000000000000000000003330003330003300003000000300003
333333330033333330003300003330000033300003330033330003330000330000333003300000000000000000000000300003
300000000030000000000330000000000000000000000000000000000000000000000000000000000000000000000000300003
300000000030000000000000000000000000000000000000000000000000000000000000000000000000000000000000300003
303333333330000000000000000000000000000000000000000000000000000000000000000000000000000000000000300003
300000000030000000000000000000000000000000000000000000000000000000000000000000000000000000000000300003
300000000030000000000000000000000000000000000000000000000000000000000000000000000000000000000000300003
333333330030000000000000000000000000000000000000000000000000000000000000000000000000000000000000300003
300000000030000000000000000000000000000000000000000000000000000000000000000000000000000000000000300003
300000000030000000000000000000000000000000000000000000000000000000000000000000000000000000000000300003
300000000030000000000000000000000000000000000000000000000000000000000000000000000000000000000000300003
300003333333333000000000000000000000000000000000000000000000000000000000000000000000000000000000300003
330000000000003000000000000000000000000000000000000000000000000000000000000000000000000000000000300003
300000000000003000000000000000000000000000000000000000000000000000000000000000000000000000000000300003
300000000000003333333333333333333333333333333333333333333333333333333333333333333333333333333333300003
333003333330000000000000000000000000000000000000000000000000000000000000000000000000000000000000300003
300003000030000000000000000000000000000000000000000000000000000000000000000000000000000000000000300003
300003000030000000000000000000000000000000000000000000000000000000000000000000000000000000000000300003
300003000033333333330030000033000330033300033333333333300303330033003330033000330033330033003000300003
300003000000000000030033300030000000033000033333333333300003300000000000000000000003300000000000300003
300003000000000000030000000000000000000000033333333333330000000000000000000000000000000000000000300003
300003000000000000030000000000000000000000030030000000000000000000000000000000000000000000000003300003
300003000000000000033333333333333333333333330030000000003000000000000000000000000000000000000000300003
300003000000000000000000000000000000000000000030000000000000000000000000000000000000000000000000300003
300003000000000000000000000000000000000000000030003333300300000000000000000000000000000000000000300003
300003000000000000000000000000000000000000000033000030000333333333333333333333333333333333333333300003
300003000000000000000000000000000000000000000030000030003300000000000000000000000000000000000000300003
300003000000000000000000000000000000000000000030030030000300000000000000000000000000000000000000300003
300003333333333333333333333333333333333333333330000033000300000000000000000000000000000000000000300003
300000000000000000000000000000000000000000000000000033300300000000000000000000000000000000000000300003
300000000000000000000000000000000000000000000000000330000300000000000000000000000000000000000000300003
300000000000000000000000000000000000000000000000000030003300000000000000000000000000000000000000300003
300003333333333333330000003300300030030030030030030030000300000000000000000000000000000000000000300003
300003333333333333333000003000000000000000000000000033000300000000000000000000000000000000000000333333
300003333333333333333300003000000000000000000000000030000300000000000000000000000000000000000000000000
300003333333333333333333333333333333333333333333333330003300000000000000000000330033000300003003000000
300000000000000000000000000000000000000000000000000000000300000333003003000300300033000333003300330003
300000000000000000000000000000000000000000000000000000000000033333000000000000000000000000000000000033
300000000000000000000000003333330333333333333333333333333333333333333333333333333333333333333333330003
300003333333333333333333330000000000000000000000000000000000000000000000000000000000000000000000003003
300000000000000000000000000000000000000000000000000000000000000000000000000000000000000000000000000003
300000000000000000000000003303333333333333333333333333333333003330003330033003330033000333000300300033
300033333333333333333333330303000000000000000000000000000003000000000300003000330003000033000300330003
300030000000000000000000000303003333333333333333333333333303000000000000000000000000000000000000033003
300030000000000000000000000303300000000000000000000300000303000000000000000000000000000000000000030003
300030033333333333330033333303000000000000000000000300000303000000000000000000000000000000000000030033
300030030000000000000000000300003333333333303333333300000303000000000000000000000000000000000000030003
300030030000000000000300000300003000000000003000000000000303000000000000000000000000000000000000030303
300030030000000000000000000003333000000000033000000000000303333333333333333333333333333333333333330003
300030030000000000000000000003000000000000003000000000000300000000000000000000000000000000000000000003
300030033333333333333333333303000000000003003000000000000333333330303030333333333333333330303033333333
300030000030003000300030003003000000000000003000000000000000000000000000000000000000000000000000000003
300030003030303030303030303003000000000033333000000000000000000000000000000000000000000000000000000003
300030003000300030003000300003000000330330003000000000000000000000000000000000000000000000000000000003
300030033333333333333333333333003300000000003000000000000000000000000000000000000000000000000000000003
300030000000000000000000000000000000000000003000000000000000000000000000000000000000000000000000000003
300030000000000000000000000000030000000000003000000000000000000000000000000000000000000000000000000003
300033333333333333333333333333333333333333333000000000000000000000000000000000000000000000000000000003
300030000000000000000000000000000000000000000000000000000000000000000000000000000000000000000000000003
300030000000000000000000000000000000000000000000000000000000000000000000000000000000000000000000000003
300030000000000000000000000000000000000000000000000000000000000000000000000000000000000000000000000003
300000000000000000000000000000000000000000000000000000000000000000000000000000000000000000000000000003
300000000000000000000000000000000333003330000000003330000000000000000000000000000000000000000000000003
333330000000000000000000033000300000000000003300000000000000000000000000000000000000000000000000000003
300000000000330000333000003300000000000000000000000000000000000000000000000000000000000000000000000003
300003330000000000000000000000000000000000000000003030333030300030033303003033300333033300303033003003
300000000000000000000000000000000000000000000000003030303030300303030303303003000300030300303030303003
300000000000000000000000000000000000000000000000003330303030300300033303033003000303030300303033003003
300000000000000000000000000000000000000000000000000030303030300303030303003003000303030300303030000003
300000000000000000000000000000000000000000000000003330333003000030030303003003000333033300030030003003
300000000000000000000000000000000000000000000000000000000000000000000000000000000000000000000000000003
333333333333333333333333333333333333333333333333333333333333333333333333333333333333333333333333333333
300000000000000000000000000000000000000000000000000000000000000000000000000000000000000000000000000003
300000000000000000000000000000000000000000000000000000000000000000000000000000000000000000000000000003
300000000000000000000000000000000000000000000000000000000000000000000000000000000000000000000000000003
300000000000000000000000000000000000000000000000000000000000000000000000000000000000000000000000000003
300000000000000000000000000000000000000000000000000000000000000000000000000000000000000000000000000003
300000000000000000000000000000000000000000000000000000000000000000000000000000000000000000000000000003
300000000000000000000000000000000000000000000000000000000000000000000000000000000000000000000000000003
300000000000000000000000000000000000000000000000000000000000000000000000000000000000000000000000000003
300000000000000000000000000000000000000000000000000000000000000000000000000000000000000000000000000003
300000000000000000000000000000000000000000000000000000000000000000000000000000000000000000000000000003
300000000000000000000000000000000000000000000000000000000000000000000000000000000000000000000000000003
300000000000000000000000000000000000000000000000000000000000000000000000000000000000000000000000000003
300000000000000000000000000000000000000000000000000000000000000000000000000000000000000000000000000003
300000000000000000000000000000000000000000000000000000000000000000000000000000000000000000000000000003
300000000000000000000000000000000000000000000000000000000000000000000000000000000000000000000000030303
303030000000003333033303300333033330333303000300000303000000003333033303300333033330333303000300000003
300000030300003000003003030300030000300303000300000000003030003000003003030300030000300303000300030303
303030000000003330003003300333033300333303000300000303000000003330003003300333033300333303000300003003
300300030300003000003003030300030000300303000300000030003030003000003003030300030000300303000300000003
300000003000003000033303030333030000300303330333000000000300003000033303030333030000300303330333000003
300000000000000000000000000000000000000000000000000000000000000000000000000000000000000000000000000003
333333333333333333333333333333333333333333333333333333333333333333333333333333333333333333333333333333

